111111
1P0001
10C0?1
1000E1
111111
