111111111
10PE0C0C1
111111111
