111111
1P0001
100001
10C0E0
111111
