111111
1P0001
111111
1C0E01
111111
